ability|inability
able|unable
abnormal|normal
abnormality|normality
abolish|establish
aboriginal|nonnative
above|below
aboveboard|dishonestly
abridge|expand
absence|presence
absent|present
absolute|relative
absolve|blame
absorb|emit
absorbent|nonabsorbent
absorptive|nonabsorbent
abstain|consume
abstainer|drinker
abstemious|gluttonous
abstinent|drinker
abstract|concrete
abstractly|concretely
abstractness|concreteness
abstruseness|clarity
abundance|scarcity
abundant|scarce
accentual|quantitative,syllabic
acceptably|intolerably,unacceptably
accidentally|deliberately
acclivity|descent
accommodate|disoblige
accord|disagreement
accordant|discordant
accuracy|inaccuracy
accurate|inaccurate
accurately|inaccurately
accustomed|unaccustomed
acidic|alkaline
acquiesce|dissent
acquire|lose
acquit|convict
acquittal|conviction
action|inaction,inactivity
activate|inactivate
activation|deactivation,inactivation
activator|inhibitor
active|inactive,dormant,passive,quiet,extinct
actively|passively
activeness|inaction,inactivity
activity|inactivity,inaction
actual|potential
acute|obtuse,chronic
acutely|chronically
acuteness|obtuseness
addictive|nonaddictive
addition|subtraction
adequacy|inadequacy
adjust|skew
admissible|inadmissible
admit|deny,reject,exclude
adopted|native
adoptive|native,biological
adroit|maladroit
advantage|penalty,disadvantage
advisable|inadvisable
advised|ill-advised
advisedly|accidentally
afloat|aground,sunken
agreeably|disagreeably,unpleasantly
aground|afloat,sunken
ahead|back,backward
alas|fortunately,luckily
alfresco|indoors,inside
alkaline|acidic
allow|disallow,forbid
also-ran|winner
alterable|unalterable
alternate|opposite
altogether|partly
altruism|egoism
altruistic|egoistic
always|never
amateur|professional
amateurishly|expertly
ambidextrous|left-handed,right-handed
amoral|immoral,moral
amphibious|aquatic,terrestrial
analogous|homologous
analysis|synthesis
analytic|synthetic
analytical|synthetic
analyze|synthesize
androgynous|female,male
animal|mineral,vegetable
annual|biennial,perennial
anterior|posterior
anticyclone|cyclone
antonym|antonym,synonym
antonymous|antonymous,synonymous
appear|disappear
appetizing|unappetizing
applied|theoretical
apply|exempt,defy
appointed|elective
appointive|elective
aquatic|amphibious,terrestrial
aright|incorrectly,wrongly
armament|disarmament,disarming
armed|unarmed
armored|unarmored
arouse|sedate
arrange|disarrange
arrive|leave
arrogate|forfeit
associate|dissociate
assure|worry
astern|fore
asymmetric|symmetrical
asymmetrical|symmetrical
asymmetry|symmetry
attach|detach
attachable|detachable
attack|defend
attend|miss
attention|inattention
attentive|inattentive,heedless
attract|repel
attraction|repulsion
attractive|unattractive,repulsive
attributive|predicative
atypical|typical
atypically|typically
audibility|inaudibility
audible|inaudible
audibly|inaudibly
augmentation|diminution
aunt|uncle
auntie|uncle
aunty|uncle
aurora|sunset
autumnal|summery,vernal,wintry
available|unavailable
avoid|confront,validate
avoidable|inevitable
avoirdupois|leanness
avouch|disavow
avow|disavow
awake|asleep
aware|unaware,unmindful,unwitting
away|home
awful|nice
awkward|graceful
awkwardness|gracefulness
back|front,advance,veer,ahead,forward
background|foreground
backward|ahead,forward
badly|well
badness|good,goodness
bank|distrust,mistrust
basic|incidental
befittingly|unsuitably
beginning|middle
being|nonexistence
believably|unbelievably
below|above,upstairs
bemire|clean
bend|unbend,straighten
beneath|above
beneficence|maleficence
beneficent|maleficent
benevolence|malevolence
benignity|malignancy,malignity
biennial|annual,perennial
bigness|littleness,smallness
biped|quadruped,quadrupedal
bipedal|quadruped,quadrupedal
bisexual|heterosexual,homosexual
bivalent|univalent
bivalve|univalve
black|white,whiten
blacken|whiten
blackness|white
blame|absolve
blandish|disparage
block|unblock,unfreeze
blonde|brunet
bloodless|bloody
bloody|bloodless
blow|conserve
blubber|leanness
blue-collar|white-collar
blunt|enliven,sharpen
bluntness|sharpness
blurriness|distinctness,sharpness
bottom|side
brace|sedate
brave|cowardly
breakable|unbreakable
breast-fed|bottle-fed
breathing|breathless
breathless|breathing
bridgeable|unbridgeable
bright|dull
brighten|darken,overcast
brightness|dullness
broaden|specialize
brotherly|sisterly
brunet|blond
brunette|blond
buckle|unbuckle
bulk|minority
bull|bear
bump|promote
bumpy|smooth
burden|unburden
cacophonous|euphonious
calculable|incalculable
calm|stormy,discomposure
capability|incapability
carefully|carelessly
carefulness|carelessness
careless|careful
carelessly|carefully
carelessness|carefulness
carnivorous|herbivorous,omnivorous
cash|credit
cautiously|carelessly
celebrity|infamy
cenobite|eremite
center|right
central|peripheral
centralize|decentralize
centrally|peripherally
centrifugal|centripetal
centripetal|centrifugal
cephalic|caudal
cerebral|emotional
certain|uncertain,unsealed,unsure
changeless|mutable
charge|calm,discharge
chariness|unwariness
charitable|uncharitable
chaste|unchaste
cheap|expensive
cheaply|expensively
check|disagree
cheer|complain,dishearten
cheerful|cheerless
cheerfully|cheerlessly
cheerless|cheerful
cheerlessly|cheerfully
child|parent
chill|heat
choke|unclog
chromatic|diatonic
chronic|acute
chronically|acutely
cipher|decode
circular|square
civil|uncivil,sidereal
civilian|military,serviceman
clarity|obscurity
clasp|unclasp
classicist|romanticist
classified|unclassified
classify|declassify
clean|dirty,unfairly,unclean
cleanness|dirtiness
clear|cloudy,convict,bounce,overcast,unclear,clutter,opaque
clearheaded|confused
clearness|obscurity
close|open,distant
closed|open
closeness|openness
closing|opening
clot|homogenize
code|decode
cognizable|unknowable
cognizant|unaware
coherence|incoherence
coherency|incoherence
coherent|incoherent
coherently|incoherently
cohesion|incoherence
cohesiveness|incoherence
coil|uncoil
cold|hotness
coldness|hotness
collected|uncollected
colonize|decolonize
colorful|colorless
colorless|colorful
commencement|middle
committed|uncommitted
commodious|incommodious
common|uncommon,individual
commonly|remarkably
commonness|uncommonness
compact|loose,decompress
compactness|distribution
comparable|incomparable
comparably|incomparably
compatible|incompatible
compatibly|incompatibly
compensate|wrong
competence|incompetence
competency|incompetence
competent|incompetent
competition|cooperation
complain|cheer
complainant|defendant
complete|incomplete
completely|partly
compress|decompress
concave|convex
concavely|convexly
conceal|show
concentrate|decentralize
concentrated|soft,unsaturated
concentric|eccentric
concern|unconcern
concerned|unconcerned
conciliatory|antagonistic
concise|prolix
conclusion|beginning
conclusive|inconclusive
concord|disagree
concrete|abstract
concretely|abstractly
concreteness|abstractness
concur|disagree
condemnation|acquittal,approbation
conductor|insulator
confidence|diffidence
confine|free
confined|unconfined,invasive
confirm|negate
confirmed|unconfirmed
conform|deviate
congruence|incongruity
congruity|incongruity
connotative|denotative
conscious|unconscious
conscript|volunteer
consecrate|desecrate
constructive|destructive
consume|abstain
consumptive|generative
contemptible|estimable
content|discontented,discontent
contract|expand,stretch
converge|diverge
convergence|divergence
convinced|unconvinced
convincing|unconvincing
cool|warm,heat
cooperation|competition
correct|wrong,incorrect
correctly|wrongly,incorrectly
correctness|wrongness
countenance|disallow,forbid
courteously|impolitely
critical|noncritical,uncritical
critically|uncritically
criticize|praise
crooked|straight
crookedness|straightness
cross|uncross
crossbred|purebred
cross-eyed|walleyed
crosswise|lengthwise
crowded|uncrowded
crowned|uncrowned
crude|refined
cubic|linear
curdle|homogenize
curly|straight
curse|bless,communicate
cursed|blessed
curved|straight
custom|ready-made
custom-built|ready-made
custom-made|ready-made
cyclone|anticyclone
damn|bless
dampen|stimulate
danger|safety
dangerous|safe
daring|timidity
dark|light
darken|brighten
daytime|night
deactivate|activate
deactivation|activation
dead|animate,alive,living,live
deaden|enliven
deaf|hearing
death|birth
debark|embark
debarkation|embarkation
debilitating|invigorating
debit|credit
debtor|creditor
decease|birth
deceitfully|honestly
deceive|undeceive
decelerate|accelerate
deceleration|acceleration
decency|indecency
decent|indecent,improperly
decently|indecently,improperly
decentralize|concentrate,centralize
deciduous|evergreen
decipher|encode
decision|indecision
decisive|indecisive
decisively|indecisively
decisiveness|indecision
decode|encode
decompress|tense,compress
decorous|indecorous
decorously|indecorously
decrease|increment,increase
deduction|addition
deductive|inductive
defense|offense
deficiency|adequacy,sufficiency
deflation|inflation,disinflation
dehumanize|humanize
dehumidify|humidify
dehydrate|hydrate
deject|elate
dejected|elated
delay|rush
delete|record
deliberate|unstudied
deliberately|accidentally
delicate|rugged
delight|disenchant,displease
demand|supply,obviate
demanding|undemanding
demilitarize|militarize
demobilize|mobilize
dependable|undependable,unreliable
dependably|unreliably
depressurize|pressurize
descend|rise,ascend
desensitize|sensitize
desiccate|hydrate
desirable|undesirable
desist|consume
despair|hope
destabilize|stabilize
destructive|constructive
detach|attach
detachable|attachable
detain|free,rush
deter|persuade
deteriorate|recuperate
determined|undetermined
deterrence|incentive
detest|love
dethrone|enthrone
different|like
difficult|easy,manageable
difficulty|ease
diffidence|confidence
diffuse|hard
digestible|indigestible
digital|analogue
dignified|undignified
dilate|contract
diligent|negligent
dilute|undiluted
diminish|increase
diminution|increase,augmentation
diploid|haploid
direct|inverse,collateral,retrograde
directly|indirectly
directness|indirectness
dirtiness|cleanness
dirty|clean
disable|enable
disadvantage|advantage
disallow|allow,permit
disarmament|armament
disarming|armament
discharge|charge
disclaim|claim
discolor|color
discomfort|comfort
discomposure|composure
disconnect|connect
disconnected|legato
disconsolate|consolable
discontent|contented
disentangle|snarl,entangle
disesteem|esteem,respect
disfranchise|enfranchise
disgrace|honor
dishearten|hearten
dishonest|honest
dishonestly|honestly
dishonesty|honesty
dishonor|honor
dishonorable|honest,honorable,glorious
dishonorably|honorably
disillusion|enchant
disincline|dispose
disinclined|inclined
disinfect|infect
disinflation|inflation,deflation
disobedience|compliance,obedience
disorder|order,orderliness
disorganize|organize
disrespect|esteem,respect
disrobe|dress
distinctness|softness
distrust|trust
diverge|converge
divergence|convergence
diversify|specialize
double|univalent
down|upwardly,upward,upwards
downplay|foreground
downriver|upstream,upriver
downstream|upstream,upriver
downward|upwardly,upward,upwards
downwards|upwardly,upward,upwards
downwind|upwind,leeward
dress|undress
drinkable|undrinkable
drinker|nondrinker
drive|attract
drop|recuperate,sharpen
drop-off|increase
drowsiness|wakefulness
drunk|sober
drunkenness|soberness
dry-eyed|tearful
dryness|wetness
dubiety|certainty
dubiousness|certainty
dull|lively,sharpen,sharp,bright
dullness|sharpness
early|middle,late
earthly|heavenly
ease|difficulty
easiness|difficulty
east|west
easterly|westerly
eastern|western
easy|quickly,difficult,uneasy
eatable|inedible
effluence|influx,inflow
egress|immersion,ingress
emotional|unemotional,cerebral
empirical|theoretical
employ|unemployment,fire
employable|unemployable
employee|employer
employer|employee
employment|unemployment
emptiness|fullness
empty|full,fill
enable|disable
enchant|disenchant
enchanted|disenchanted
encipher|decode
enclosed|unenclosed
encode|decode
endemic|epidemic
ending|beginning,middle
endogenous|exogenous
endure|enjoy
enemy|friend
energetic|lethargic
energize|sedate
enforce|exempt
engage|fire,disengage
enjoy|suffer
enjoyably|disagreeably
enlarge|reduce,contract
enlargement|contraction
enlightening|unedifying
enlist|discharge
entangle|unsnarl,disentangle
epidemic|endemic
equally|unequally,unevenly
equity|inequity,unfairness
esteem|disesteem,disrespect
evenly|unequally,unevenly
evenness|variability,unevenness
evil|goodness,good
evilness|goodness,good
exactly|inexactly,imprecisely
exaggerate|understate
exasperate|better
except|include
excite|calm,stifle
excited|unexcited
exciting|unexciting
exclude|include,admit
exclusion|inclusion
exclusive|inclusive
exculpate|convict
excusable|inexcusable
excusably|unpardonably,unforgivably,inexcusably
exempt|nonexempt,taxable,enforce
exhale|inhale
exile|repatriate
existence|nonexistence
exogenous|endogenous
expedience|inexpediency
expediency|inexpediency
expire|inhale
explicable|inexplicable
explicit|implicit
explicitly|implicitly
explode|implode
explosive|nonexplosive
export|import
exportation|import
expose|cover
expound|contract
express|local
extant|extinct
extensive|intensive
exterior|interior,inside
external|internal
externally|internally
extinct|active,extant
extinguish|ignite
extroversion|introversion
extrusive|intrusive
eyed|eyeless
eyeless|eyed
face|avoid,back
fail|pass,succeed,manage
failing|passing
failure|success,achiever
fair|unfair,unfairly,partial,foul
fairly|unfairly,immoderately
fairness|inequity,unfairness
faithful|unfaithful
faithfully|unreliably,unfaithfully
fall|rise,ascend
fame|infamy
familiar|unfamiliar,strange
famish|feed
fancy|plain
farsighted|nearsighted
fast|slow
fasten|unfasten
fastness|looseness
father|mother
favorable|unfavorable
favorably|unfavorably
fear|fearlessness
fearful|brave
fearfully|fearlessly
fearfulness|fearlessness
fearless|afraid
fearlessly|fearfully
fearlessness|fear,fearfulness
featherless|feathered
feature|lack
fecundity|infertility
federal|unitary
feed|starve
feelingly|unfeelingly
felicitous|infelicitous
female|androgynous,male
feminine|neuter,masculine
fidelity|infidelity
figurative|literal
figuratively|literally
figure|ground
filial|parental
fill|empty
find|lose
fine|coarse
finely|coarsely
finish|begin,beginning,start
finished|unfinished
finite|infinite
finitely|infinitely
fire|hire
first|middle,last,intermediate
fitly|unsuitably
fittingly|unsuitably
fixity|mutability
flat|natural,sharp,indirectly
flatten|sharpen
flatter|disparage
flattering|unflattering
flawlessness|imperfection
fleece|undercharge
flex|straighten,unbend
flexible|inflexible
flexibly|inflexibly
float|sink
flora|fauna
flunk|passing,pass
focus|blur
fogginess|sharpness,distinctness
forbid|allow,permit
foreground|background
forgiving|unforgiving
forgo|claim,postdate
formal|informal
formalism|imitation
formality|informality
formalize|invalidate
formally|informally
former|latter
fortuitously|unluckily
fortunately|unluckily
forward|backward,back
four-footed|biped,bipedal
free|freeze,block
freeze|unblock,unfreeze
frequent|boycott
frequently|rarely,infrequently
friendly|hostile
fright|fearlessness
frigidity|hotness
frigidness|hotness
frivolity|seriousness
frivolous|serious
front|back,rear
frontward|backward
frontwards|backward
frozen|unfrozen
fruitful|unfruitful
fruitfully|unprofitably,fruitlessly
fruitlessly|profitably,fruitfully,productively
full|empty,wane,thin
fullness|emptiness
full-time|part-time
future|past,present
fuzziness|sharpness,distinctness
gaseous|solid,liquid
gathered|uncollected
general|particular,specific
generic|varietal
give|take
given|taken
gladden|sadden
glorious|inglorious
gluttonous|abstemious
good|evilness,evil,badness
goodness|badness,evilness,evil
gracefully|ungracefully,ungraciously
gracelessly|gracefully,graciously
graciously|ungracefully,ungraciously
graciousness|malignancy,malignity
gratefully|ungratefully
gravity|levity
green|ripe
greenness|ripeness
grime|clean
ground|figure
grownup|juvenile
growth|decrease
haploid|diploid
hard|voiced,soft,lightly,easy
hardball|softball
harden|soften
hardhearted|softhearted
hardihood|timidity
hardiness|timidity
hardness|softness
hardware|software
harmful|harmless,advantageous,innocuous
harmfully|harmlessly
harmless|harmful,noxious
harmlessly|harmfully
harmonious|inharmonious
harmony|dissonance
harness|unharness
harsh|fine
hasten|linger
hastily|unhurriedly
hate|love
hateful|lovable
hatred|love
have|refuse,abstain,lack
hawk|dove
head|tail,foot,rear
headed|headless
headless|headed
health|illness
heat|cool
heavenly|earthly
heavily|lightly
heaviness|lightness
heavy|light
heedful|heedless
heedless|heedful
heliocentric|geocentric
helpful|unhelpful
helpfully|unhelpfully
herbivorous|omnivorous,carnivorous
here|there
hereafter|past
heresy|orthodoxy
heterodoxy|orthodoxy
heterosexual|homosexual,bisexual
highlight|background
holy|unholy
home|away
homogenize|curdle
homologous|analogous
homosexual|bisexual,heterosexual
honor|dishonor,disrespect
honorable|dishonest,dishonorable
honorably|dishonorably
hook|unhook,undercharge
hope|despair
hopeful|hopeless
hopefully|hopelessly
hopefulness|hopelessness
hopeless|hopeful
hopelessly|hopefully
horizontal|vertical,inclined
hotfoot|linger
hotness|coldness
hubby|wife
human|nonhuman
humane|inhumane
humanely|inhumanely
humanize|dehumanize
humble|proud
humbleness|pride
humidify|dehumidify
humility|pride
humorless|humorous
humorlessly|humorously
humorous|humorless
humorously|humorlessly
hungry|thirsty
hurried|unhurried
hurriedly|unhurriedly
hurry|delay
husband|wife,waste
identical|fraternal
idle|busy,work
igneous|aqueous
ignite|extinguish
ignoble|noble
ignore|know,notice
ill-advised|well-advised
illegal|legal
illegality|legality
illicitly|licitly,legitimately
illness|wellness
immersion|egress
immobilize|unblock,unfreeze
immoderately|moderately,reasonably
immoral|moral,amoral
immutability|mutability
impenitent|repentant,penitent
imperfectly|perfectly
imperishable|perishable
impermanence|permanence
impermanent|permanent
impermeable|permeable
impersonal|personal
impersonally|personally
implausibly|believably,credibly
impolitely|courteously,politely
impotence|potency,power
impotency|potency,power
imprecisely|exactly,precisely
imprecision|precision,preciseness
improbably|believably,credibly
impropriety|propriety
inability|ability
inaccessible|accessible
inaccuracy|accuracy
inaccurate|accurate
inaccurately|accurately
inaction|activeness,activity,action
inactivate|activate,mobilize
inactivation|activation
inactive|active,operational
inactivity|activity,activeness,action
inadequacy|adequacy
inadequate|adequate
inadequately|adequately
inadmissible|admissible
inadvisable|advisable
inalienable|alienable
inanimate|animate
incapability|capability
incisively|inexactly,imprecisely
inclined|horizontal,vertical
incoherent|coherent
incoherently|coherently
income|outgo
incoming|outgoing
incommodious|commodious
incomparable|comparable
incomparably|comparably
incompatible|synergistic,compatible,congenial
incompatibly|compatibly
incompetence|competence
incompetency|competence
incompetent|competent
incomplete|complete
inconclusive|conclusive
incongruity|congruity
inconsistent|consistent
inconsolable|consolable
inconstancy|constancy
inconstant|constant
incontinent|continent
inconvenient|convenient
incorrect|right,correct
incorrectly|right,correctly
increase|decrease
incredibly|believably,credibly
increment|decrease
indecision|decision,decisiveness
indigestible|digestible
indirect|direct,lineal
indirectly|directly
indirectness|directness
indiscreet|discreet
indiscreetly|discreetly
indoors|outdoors,outside
ineptness|suitableness,suitability
inequity|equity,fairness
inexact|exact
inexactly|exactly
inexactness|exactness
inexcusable|excusable
inexcusably|justifiably,pardonably,excusably
inexpediency|expediency
inexpedient|expedient
inexpensive|expensive
inexperience|experience
inexplicable|explicable
inextricable|extricable
infallible|fallible
infamy|fame
inferior|superscript
inferiority|superiority
infidelity|faithfulness,fidelity
inflation|deflation,disinflation
inflow|outflow
influx|outflow
ingress|egress
injured|uninjured
injustice|justice
inkiness|white
inland|coastal
inmate|outpatient
innate|conditioned
inner|outer
innocence|guilt
innocent|guilty
innocuous|noxious
innumerate|numerate
inoffensive|offensive,unsavory
inoperable|operable
inoperative|operative
inopportune|opportune
inorganic|organic
inpatient|outpatient
inquiry|answer
insane|sane
insanely|sanely
insanitary|sanitary
insanity|sanity
insatiable|satiate
inscribe|decode
insecure|secure
inside|outdoors,outside
insolubility|solubility
instability|stability
intemperance|temperance
intemperate|temperate
intended|unintended
intense|mild
intensity|softness
intensive|extensive
interactive|antagonistic
interdict|allow,permit
intermediate|first,last
intolerably|tolerably,acceptably
intractable|tractable
intramural|extramural
intransitive|transitive
intrastate|interstate
intrepidly|fearfully
intrinsic|extrinsic
inviolable|violable
invisibility|visibility
invisible|conspicuous,visible
invisibly|visibly
inviting|uninviting
involuntary|voluntary
involve|obviate
invulnerable|vulnerable
inward|outward
inwardly|outwardly
inwards|outward
irrational|rational
irrationally|rationally
irreducible|reducible
irregular|regular
irregularity|regularity
irregularly|regularly
irrelevance|relevance
irrelevancy|relevance
issue|recall
jade|refresh
jibe|disagree
joint|separate
joyful|sorrowful
joyfulness|sorrow
joyless|joyous
joyous|joyless
joyousness|sorrow
jubilantly|unhappily
juicer|nondrinker
jumpy|smooth
junior|senior
just|unjust,inequitable,unfair
justice|injustice
justify|blame
justly|unjustly
justness|injustice
juvenile|adult
keep|break,discontinue,lose
kickoff|middle
king|queen
knot|unravel
knowingly|unknowingly,unwittingly
lady|nobleman
large|little,small
largeness|littleness,smallness
last|intermediate,first
late|early,middle
latter|former
launch|abolish
laurels|dishonor
lawful|unlawful
lawfully|unlawfully,illicitly,lawlessly
lawfulness|unlawfulness
lawlessly|lawfully
layman|clergyman
layperson|clergyman
laze|work
lead|deficit,follow
leaded|unleaded
leader|follower
leading|following
leafless|leafy
leafy|leafless
leaky|tight
lean|rich
leanness|fatness
least|most
leave|arrive,disinherit,enter
leeward|windward,downwind
left|center,right
left-handed|ambidextrous
legal|illegal
legality|illegality
legalize|outlaw
legally|unlawfully
legato|staccato
legged|legless
legibility|illegibility
legible|illegible
legibly|illegibly
legitimacy|illegitimacy
legitimate|illegitimate,outlaw
legitimately|illicitly,lawlessly
legitimatize|outlaw
legitimize|outlaw
legless|legged
lend|borrow
lender|borrower
lengthen|shorten
lengthways|crosswise
lengthwise|crosswise
liberate|confine
liberator|captor
licit|illicit
licitly|illicitly,lawlessly
licking|victory
lidded|lidless
lidless|lidded
lifelessness|motion
lift|lower,fall
light|dark,heavy,extinguish
lighten|darken
lighting|dark
lightly|heavily,thickly
lightness|darkness,heaviness
likelihood|unlikeliness,unlikelihood
likeliness|unlikeliness,unlikelihood
likeness|unlikeness
limpidity|obscurity
linear|cubic
liquid|gaseous,solid
little|large
littleness|bigness,largeness
lively|dull
liven|deaden
living|dead
loan|borrow
loaner|borrower
local|general,national,express
location|studio
lock|unlock
long|short
look|back
loop|uncoil
lord|noblewoman
lose|profit
lost|found
loud|soft,piano,softly
loudly|piano,softly
loudness|softness
lovable|hateful
love|hate
loveable|hateful
lower-class|middle-class,upper-class
lucidity|obscurity
lucidness|obscurity
luckily|unluckily
luckiness|misfortune
magnetize|demagnetize
malady|wellness
male|female,androgynous
malignancy|benignity
malignity|benignity
manful|unmanly
manipulable|intractable
manlike|unmanly
manly|unmanly
manned|unmanned
manual|automatic
many-sided|unilateral
masculine|feminine,neuter
maxi|mini,midi
maximal|minimum,minimal
maximize|minimize
maximum|minimum,minimal
meagerly|amply
meet|diverge
member|nonmember
mend|break
mendaciously|truthfully
mendacity|veracity
mensurable|immeasurable
mental|physical
merciful|merciless
middle|late,early,beginning
middle-class|upper-class,lower-class
middling|immoderately,unreasonably
midi|maxi,mini
militarize|demilitarize
mindfulness|heedlessness
mineral|animal,vegetable
mini|midi,maxi
minimal|maximum,maximal
minimize|maximize
minimum|maximum,maximal
minor|major
minority|majority
minus|plus
minuscule|uppercase
mirthfully|unhappily
misbehave|behave
miscarry|succeed
mistrust|trust
mobilize|demobilize
moderately|immoderately,unreasonably
moisturize|dehumidify
molar|molecular
molecular|molar
monody|polyphony
moral|immoral,amoral
mother|father
move|stay,refrain,rest
moving|still
much|little
multiform|uniform
multilateral|unilateral
multilingual|monolingual
multiple|single
multiply|singly,divide
mutability|immutability
narrow|diversify
natural|sharp,flat
naturally|unnaturally
nearsighted|farsighted
neatness|untidiness
necessary|unnecessary,inessential
negative|neutral,positive
negativeness|positiveness
negativism|positiveness
negativity|positiveness
neuter|masculine,feminine
neutral|positive,negative
noble|noblewoman
nobleman|noblewoman
noblewoman|nobleman
noisily|quietly
noisy|quiet
nominal|real
nominative|oblique
nonabsorbent|absorbent
nonaddictive|addictive
nonadhesive|adhesive
nonage|majority
nonalcoholic|alcoholic
nonalignment|alignment
nondrinker|drinker
nonentity|existence
nonessential|essential
nonexempt|exempt,nontaxable
nonexistence|existence
nonexistent|existent
nonexplosive|explosive
nonfat|fatty
nonfatal|fatal
nonfictional|fictional
nonlinear|linear
nonliving|animate
nonmagnetic|magnetic
nonmember|member
nonmetal|metallic
nonmetallic|metallic
nonmigratory|migratory
nonmilitary|military
nonnative|native
nonpartisan|partisan
nonpayment|payment
nonpolitical|political
nonrenewable|renewable
nonresident|resident
nonrigid|rigid
nonspecific|specific
nonsurgical|surgical
nontaxable|taxable
nontechnical|technical
nontoxic|toxic
objectify|personalize
oblique|parallel
offense|defense
offset|middle
often|rarely,infrequently
oftentimes|rarely,infrequently
ofttimes|rarely,infrequently
okay|disapprove
oldness|newness
omit|include
omnivorous|carnivorous,herbivorous
one-sided|reversible,multilateral
onshore|offshore
onside|offside
on-site|off-site
onstage|offstage
opacity|clarity,transparency
opaque|clear
opaqueness|clarity
open|closed,covert,shut,close,fold
opening|closing
openness|closeness
operable|inoperable
operate|disengage,malfunction
operative|inoperative,medical
opportune|inopportune
opposed|unopposed
opposite|alternate,synonym
opprobrium|fame
optimism|pessimism
optimist|pessimist
optimistic|pessimistic
order|disorder
orderliness|disorder
organize|disorganize
orientate|disorient
original|unoriginal
orthodox|unorthodox
other|same
outdoors|indoors,inside
outflow|influx,inflow
outgoing|incoming
outlaw|legalize
outlay|income
out-of-door|indoor
outpatient|inpatient
outset|middle
outside|inside,indoors,indoor
outward|inward
outwardly|inwardly
outwards|inward
outwear|refresh
overact|underact
overarm|underhand
overbid|underbid
overcharge|undercharge
overestimate|undervalue
overhead|surface,subsurface
overvalue|undervalue
oviparous|viviparous
paranormal|sensory,normal
parasite|host
pardonable|unpardonable
pardonably|unpardonably,unforgivably,inexcusably
parent|child
parental|filial
part|wholly
partial|impartial
partiality|impartiality
partially|wholly
particular|general
partisan|nonpartisan
partisanship|impartiality
partly|wholly
passably|immoderately,unreasonably
past|present,future
patrician|plebeian,proletarian
patronize|boycott
peel|dress
peeress|nobleman
penitent|unrepentant,impenitent
perennial|annual,biennial
permanence|impermanence
permanency|impermanence
permanent|impermanent
permanently|temporarily
permeable|impermeable
permissive|preventive
permit|disallow
piece|disassemble
piety|impiety
pigeon-toed|splayfooted
pious|impious
piously|impiously
piousness|impiety
place|divest
pleasantly|disagreeably,unpleasantly
plebeian|proletarian,patrician
politely|impolitely
poor|rich
positive|negative,neutral
positiveness|negativeness,negativity
postnatal|prenatal
postpartum|prenatal
potency|impotence,impotency
precisely|inexactly,imprecisely
preciseness|imprecision
precision|imprecision
prenatal|postnatal
present|future,past
pressurize|depressurize
preventative|permissive
preventive|permissive
prewar|postwar
pride|humility
prize|disesteem,disrespect
pro-choice|pro-life
productive|unproductive,consumptive
productively|unprofitably,fruitlessly
profane|sacred
professional|amateur
profit|lose
profitable|unprofitable
profitably|unprofitably,fruitlessly
profound|superficial
profoundness|shallowness
profundity|shallowness
progress|recede,regress
progressive|regressive,conservative
prohibit|allow
proletarian|patrician,plebeian
propriety|impropriety
proscribe|allow,permit
provincial|cosmopolitan
proximate|ultimate
prudence|imprudence
prudent|imprudent
prudently|imprudently
public|private
publicly|privately
pull|repel
pureness|impurity
purge|rehabilitate
purity|impurity
purposeful|purposeless
purposeless|purposeful
purposely|accidentally
push|pull
quadruped|biped,bipedal
quadrupedal|biped,bipedal
quantitative|syllabic,accentual
queen|king
quiet|sound,agitate,noisy,unquiet
quietly|noisily,loudly
quit|stay,continue,enter
ravel|unravel
ravish|disenchant
rawness|completeness,experience
raze|raise
readability|illegibility
ready|unready
ready-made|custom-made
real|unreal,nominal
realism|unreality
reasonably|immoderately,unreasonably
reassure|worry
recall|forget,issue
recede|advance,gain
received|nonstandard
recessive|dominant
recollect|forget
record|erase
recover|deteriorate
recreate|dishearten
rectifiable|irreparable
rectify|falsify
recto|verso
recuperate|deteriorate
redress|wrong
reduce|expand,gain,oxidize
reducible|irreducible
reduction|increase
refined|unrefined
refrain|consume
refresh|tire
refuse|accept,allow,admit
regain|lose
regard|disesteem,disrespect
regrettably|luckily,fortunately
regularly|irregularly
regulate|deregulate
rehabilitate|purge
reject|approve,accept,admit
rejection|acceptance
relax|strain,tense
release|freeze,block
reliable|undependable,unreliable
reliably|unreliably
rely|mistrust,distrust
repentant|unrepentant,impenitent
resident|migratory,nonresident
resist|surrender
resistible|irresistible
resistless|resistible
resolute|irresolute
resolutely|indecisively,irresolutely
resolution|preparation
respect|disesteem,disrespect
rest|change
restore|break
restrained|unrestrained
restricted|unrestricted
retail|wholesale
retard|accelerate
retrogress|progress
revalue|depreciate
reverence|irreverence
reverend|layman
reverent|irreverent
reverently|irreverently
reversal|affirmation
reverse|forward,obverse
rich|poor
right|left,center,wrongly,incorrectly,wrong,incorrect,wrongfulness
rightfulness|wrongfulness,wrong
right-handed|left-handed,ambidextrous
rightness|wrongness
ripe|green
ripeness|greenness
rise|fall,wane,descent
rising|fall
rivalry|cooperation
robust|frail
rocky|smooth
roll|unwind
romantic|classicist
romanticism|classicism
romanticist|classicist
roofed|roofless
roofless|roofed
root|descendant
rotten|fresh
rough|smooth
roughen|smooth
roughness|smoothness
round|square
rounded|angular
rudely|courteously,politely
sadist|masochist
sadistic|masochistic
sadly|happily
sadness|happiness
safe|dangerous
safety|danger
sagely|foolishly
salable|unsalable
salaried|freelance
saleable|unsalable
saneness|insanity
sanitary|unsanitary
sanity|insanity
satisfy|dissatisfy
saturated|unsaturated
scent|deodorize
sectarian|nonsectarian
secular|clergyman
secure|insecure,unprotected,unfasten
securely|insecurely
security|insecurity
sedate|stimulate
sedimentary|igneous
seedless|seedy
seedy|seedless
seemliness|unseemliness
segregate|desegregate
segregated|integrated
segregation|integration
seldom|often
self-doubt|confidence
selfish|unselfish
selfishly|unselfishly
selfless|egoistic
selflessness|egoism
sensitize|desensitize
separably|inseparably
separate|joint,unite
separation|union
septic|antiseptic
serious|frivolous,playful
seriousness|frivolity
service|disservice
serviceman|civilian
settle|float
settled|unsettled
sexual|asexual
sharp|flat,natural
sharpness|softness
shop|boycott
shrink|expand,stretch
sickness|wellness
side|bottom
similitude|unlikeness
simple|complex,compound
simpleness|difficulty,complexity
simplicity|difficulty,complexity
simplify|complicate
sincere|insincere
sincerely|insincerely
sincerity|frivolity,insincerity
single|multiple,double,common,married
singly|multiply
singular|plural
sink|float,source
sinkable|unsinkable
slenderness|thickness
slim|gain
sloppiness|carefulness
slow|fast
small|large
smallness|bigness,largeness
smoker|nonsmoker
smoky|smokeless
smooth|rough,roughen,staccato
smoothness|roughness
snarl|unsnarl
soak|undercharge
sober|intoxicated,playful
soberness|drunkenness
sobriety|drunkenness
sociable|unsociable
socialism|capitalism
socialist|capitalistic
socialistic|capitalistic
soft|hard,forte,unvoiced,loud
softball|hardball
soft-boiled|hardhearted
soften|harden,sharpen,stand
softness|sharpness,distinctness
solid|liquid,gaseous
solubility|insolubility
somewhat|immoderately,unreasonably
sonic|subsonic,supersonic
so-so|intolerably,unacceptably
sound|silence,unsound
soundness|unsoundness
sour|sweet,sweeten
source|sink
south|north
southern|northern
sparingly|amply
specialize|diversify
specific|general,nonspecific
speed|decelerate,linger
speedily|slowly
speedup|deceleration
spineless|vertebrate
spiny|spineless
spirited|spiritless
sponsor|boycott
spotlight|background
stability|instability
stabilize|destabilize
start|middle
stay|change,move,depart
steadily|unsteadily
steadiness|unsteadiness
steady|unsteady,unsteadily
steep|gradual
stemless|stemmed
stemmed|stemless
step-down|increase
step-up|decrease
sterile|fertile
sterility|fertility
stick|dislodge,move
stiff|impotent
stiffen|loosen
stifle|stimulate
stigmatic|astigmatic
still|agitate,moving,sparkling
stillness|motion
stimulate|sedate,stifle
stimulative|depressant
stinginess|generosity
stingy|ample,generous
stinky|fragrant
stop|continue,begin,start
stormy|calm
straddle|side
strain|relax
strap|unstrap
strength|weakness
strengthen|weaken
stressed|unstressed
stretch|shrink
strict|indulgent
strike|miss
strip|dress
submerged|afloat,aground
subscript|superscript
subsonic|supersonic,sonic
subsurface|overhead,surface
sufficiency|inadequacy
suitably|unsuitably
summery|autumnal,wintry,vernal
sundown|sunrise
sunken|afloat
sunrise|sunset
sunset|sunrise
sunup|sunset
superficial|profound
superhuman|subhuman
superior|inferior,subscript
superiority|inferiority
superscript|subscript
supersonic|sonic,subsonic
sure|unsure,uncertain
surface|subsurface,overhead
suspect|trust
swear|mistrust,distrust
syllabic|accentual,quantitative
synergistic|antagonistic
synonym|antonym
synonymous|antonymous
synthesis|analysis
synthesize|analyze
synthetic|analytic
systematic|unsystematic
take|disclaim,abstain,refuse,obviate,give
taken|given
talented|untalented
tall|short
tallness|shortness
tangle|unsnarl,disentangle,unravel
tardily|early,quickly
tardiness|punctuality
tasteful|tasteless
tastefully|tastelessly
tasteless|tasteful,tasty
tastelessly|tastefully
tastily|tastelessly
tasty|tasteless
tautness|looseness
taxable|nontaxable
technical|nontechnical
temperance|intemperance
temperate|intemperate
tense|relax
terminate|begin
terrestrial|amphibious,aquatic
theoretic|empirical
theoretical|applied,empirical
there|here
thick|thinly,thin
thicken|thin
thickly|thinly
thickness|thinness
thin|thick,thicken,gain,full,thickly
think|forget
thinkable|unthinkable
thinly|thickly
thinness|thickness,fatness
thirsty|hungry
thither|here
thoughtful|thoughtless
tidiness|untidiness
tidy|untidy
timeliness|untimeliness
tire|interest,refresh
titled|untitled
toadstool|mushroom
tolerably|intolerably,unacceptably
traceable|untraceable
tractable|intractable
tragedy|comedy
trained|untrained
tranquilize|agitate,stimulate
trust|mistrust,distrust
two-handed|right-handed,left-handed
unacceptably|tolerably,acceptably
unadvised|well-advised
unaesthetic|aesthetic
unaffected|affected
unafraid|afraid,insecure
unarmed|armed
unarmored|armored
unashamed|ashamed
unashamedly|ashamedly
unassertive|assertive
unbelievably|believably,credibly
unblock|freeze,block
unbreakable|breakable
unbridgeable|bridgeable
unbroken|broken
unbuckle|buckle
unburden|burden
uncertain|sure,certain
unclasp|clasp
unclothe|dress
uncollected|gathered,collected
uncommon|common
uncommonness|commonness
unconcern|concern
unconcerned|concerned
unconfined|confined
unconfirmed|confirmed
uncongenial|congenial
unconnected|connected
unconscious|conscious
uncover|cover
uncritical|critical
uncritically|critically
uncross|cross
uncrowded|crowded
uncrowned|crowned
uncultivated|cultivated
uncut|mown
undeceive|deceive
undependable|dependable,reliable
undervalue|overestimate,overvalue
undetermined|determinate,determined
undeveloped|developed
undignified|dignified
undiplomatic|diplomatic
undress|dress
unemployment|employment
unenclosed|enclosed
unendurable|tolerable
unequally|equally,evenly
unevenly|equally,evenly
unevenness|evenness
unfairness|equity,fairness
unfaithfully|reliably,dependably,faithfully
unfamiliar|familiar
unfasten|fasten
unfathomable|fathomable
unfavorable|favorable
unfavorably|favorably
unfeelingly|feelingly
unfinished|finished
unfit|qualify
unfitness|ability,fitness
unflattering|flattering
unfold|fold
unforgivably|pardonably,excusably
unforgiving|forgiving
unfreeze|freeze,block
ungracefully|gracefully,graciously
ungraciously|gracefully,graciously
ungratefully|gratefully
unhallowed|holy
unhappily|happily
unhappiness|happiness
unhappy|euphoric,happy
unhardened|tempered
unharness|harness
unhealthful|healthful,sanitary
unhealthy|healthy
unhelpful|helpful
unhelpfully|helpfully
unhitch|hitch
unholiness|holiness
unholy|holy
unhook|hook
unhurried|hurried
unhurriedly|hurriedly
unicameral|bicameral
unification|separation,disunion
uniform|multiform
unify|divide
unilateral|multilateral
unilaterally|bilaterally
unimpaired|impaired
univalent|bivalent
universal|particular
unjust|just,equitable,fair
unjustly|justly
unkind|kind
unkindly|kindly
unkindness|kindness
unknowable|knowable
unknowingly|wittingly,knowingly
unknown|known
unlikelihood|likeliness,likelihood
unlikeliness|likeliness,likelihood
unlikeness|similitude,likeness
unlock|lock
unluckily|luckily,fortunately
unmanageable|manageable
unmanly|manly,manfully
unmanned|manned
unmarked|marked
unmarried|married
unmask|mask
unmoral|moral,immoral
unmusical|musical,melodious
unnatural|unaffected,natural
unnaturally|naturally
unnecessary|necessary
unneeded|necessary
unnoticeable|noticeable,obtrusive
unobtrusive|obtrusive
unoccupied|occupied
unofficial|official
unofficially|officially
unopposed|opposed
unorganized|organized
unoriginal|original
unorthodox|orthodox
unpack|pack
unpaid|paid
unpalatable|palatable
unpardonable|pardonable
unpardonably|pardonably,excusably
unpatriotic|patriotic
unpleasant|pleasant
unpleasantly|pleasantly
unpolished|polished
unpopular|popular
unpopularity|popularity
unprejudiced|prejudiced
unprepared|prepared
unprincipled|principled
unprintable|printable
unprocessed|refined
unproductive|productive
unprofitable|profitable
unprofitably|profitably,fruitfully,productively
unpropitious|propitious
unprotected|protected
unravel|knot,ravel
unreasonably|moderately,reasonably
unreliable|dependable,reliable
unreliably|reliably,dependably
unrepentant|repentant,penitent
unrighteous|righteous
unripe|ripe
unripened|ripe
unroll|wind
unsaddle|saddle
unsafe|safe,secure
unsalable|salable
unsanitary|sanitary
unsaturated|saturated
unscramble|knot,ravel
unsettled|settled
unshapely|shapely
unshaven|shaven
unsheathe|sheathe
unshod|shod
unsinkable|sinkable
unsnarl|snarl,entangle
unsoundness|soundness
unsuitably|suitably
unsure|sure,certain
unsurprising|surprising
unsystematic|systematic
untangle|knot,ravel
untimeliness|timeliness
unusual|familiar
unvaried|varied
unvarying|multiform,varied
unveil|veil
unvoiced|voiced
unwanted|wanted
unwarily|warily
unwariness|wariness
unwary|wary
unwind|strain,tense
unwisely|wisely
unwitting|witting
unwittingly|wittingly,knowingly
unworldly|worldly
unworthiness|worthiness
unworthy|worthy
unwoven|woven
unwrap|wrap
unwrinkled|furrowed,wrinkled
upper-class|lower-class,middle-class
upriver|downstream,downriver
upstream|downstream,downriver
upward|downward,downwards,down
upwardly|downward,downwards,down
upwards|downward,downwards,down
upwind|downwind,windward
usefulness|uselessness
uselessness|usefulness,utility
utility|uselessness
value|disesteem,disrespect
variability|evenness
varietal|generic
vegetable|mineral,animal
ventral|dorsal
veracity|mendacity
verbal|numerical
verbosity|terseness
verity|falsity
vernal|summery,autumnal,wintry
verso|recto,obverse
vertebrate|invertebrate
vertical|inclined
veto|allow,permit
viviparous|oviparous
vowel|consonant
vulnerable|invulnerable
waive|claim
wake|sleep
wakefulness|sleepiness
walk|ride
walk-on|speaking
walleyed|cross-eyed
wanted|unwanted
warily|unwarily
wariness|unwariness
warm|cool
weak|strong
weaken|strengthen,escalate
weakly|strongly
weakness|strength
wealth|poverty
wealthiness|poverty
wear|refresh
wearable|unwearable
weary|refresh
wedge|dislodge
weedless|weedy
weedy|weedless
weep|laugh
weight|unburden
well|badly
wellness|illness
wetness|dryness
whisper|shout
white|black,blacken
white-collar|blue-collar
whiten|blacken
whiteness|black
whole|fractional,half,partly
wholesale|retail
wholesome|unwholesome
wholly|partly
wicked|virtuous
wide|narrow
widen|narrow
wideness|narrowness
wife|husband
wild|tame
wildness|tameness
will|disinherit
willing|unwilling
willingly|unwillingly
windward|upwind,leeward
wintery|vernal,summery,autumnal
wintry|autumnal,vernal,summery
wired|wireless
wireless|wired
wisdom|folly,unsoundness
wise|foolish
wisely|foolishly
wish|begrudge
wittingly|unknowingly,unwittingly
woodenly|gracefully,graciously
worldliness|naivete
worldly|unworldly
worrisome|reassuring
worry|reassure
worse|better
worsen|better
worst|best
worthiness|unworthiness
worthless|valuable
worthy|unworthy
woven|unwoven
wrap|unwind,unwrap
wrinkled|unwrinkled
written|spoken,unwritten,unscripted
wrong|rightfulness,right,correct,correctly
wrongfulness|rightfulness,right
wrongly|right,correctly
wrongness|rightness,correctness
year-round|seasonal
yesteryear|future
yield|stand,survive
yoke|unyoke
yore|future
young|aged
youth|aged
zealot|nonpartisan
zenith|nadir
zipper|unzip
